
NO ./textures_xpm/naturalbricks_hd_verydark.xpm
SO ./textures_xpm/naturalbricks_hd_verydark.xpm
EA ./textures_xpm/naturalbricks_hd_verydark.xpm
WE ./textures_xpm/naturalbricks_hd_verydark.xpm

C 155,100,160
F 111,111,111

111111
1 1111
1 0111
111111
1N1111
111111
